10 24 24 24 24 24 24 14 24 24 24 24 14 24 14 24 24 24 24 14 24 24 24 24 24 24 13 
20 0  0  0  0  0  0  20 0  0  0  0  20 0  20 0  0  0  0  20 0  0  0  0  0  0  20 
20 0  1  5  5  4  0  20 0  0  0  0  20 0  20 0  0  0  0  20 0  1  5  5  4  0  20 
20 0  6  9  9  8  0  20 0  0  0  0  20 0  20 0  0  0  0  20 0  6  9  9  8  0  20 
20 0  2  7  7  3  0  11 24 24 24 24 12 0  11 24 24 24 24 12 0  2  7  7  3  0  20 
20 0  0  0  0  0  0  0  0  0  0  0  0  0  0  0  0  0  0  0  0  0  0  0  0  0  20 
20 0  1  5  5  4  0  1  4  0  1  5  5  5  5  5  4  0  1  4  0  1  5  5  4  0  20 
20 0  2  7  7  3  0  6  8  0  2  7  7  7  7  7  3  0  6  8  0  2  7  7  3  0  20 
20 0  0  0  0  0  0  6  8  0  0  0  0  0  0  0  0  0  6  8  0  0  0  0  0  0  20 
11 24 24 24 24 13 0  6  8  0  1  5  4  0  1  5  4  0  6  8  0  10 24 24 24 24 12 
0  0  0  0  0  20 0  6  8  0  2  7  3  0  2  7  3  0  6  8  0  20 0  0  0  0  0  
0  0  0  0  0  20 0  6  8  0  0  0  0  0  0  0  0  0  6  8  0  20 0  0  0  0  0  
0  0  0  0  0  20 0  6  8  0  0  10 25 26 22 13 0  0  6  8  0  20 0  0  0  0  0  
10 24 24 24 24 12 0  2  3  0  0  20 0  0  0  20 0  0  2  3  0  11 24 24 24 24 13 
20 0  0  0  0  0  0  0  0  0  0  20 0  0  0  20 0  0  0  0  0  0  0  0  0  0  20 
11 24 24 24 24 13 0  1  4  0  0  20 0  0  0  20 0  0  1  4  0  10 24 24 24 24 12 
0  0  0  0  0  20 0  6  8  0  0  11 24 24 24 12 0  0  6  8  0  20 0  0  0  0  0  
0  0  0  0  0  20 0  6  8  0  0  0  0  0  0  0  0  0  6  8  0  20 0  0  0  0  0  
0  0  0  0  0  20 0  6  8  0  1  5  4  0  1  5  4  0  6  8  0  20 0  0  0  0  0  
10 24 24 24 24 12 0  6  8  0  2  7  3  0  2  7  3  0  6  8  0  11 24 24 24 24 13 
20 0  0  0  0  0  0  6  8  0  0  0  0  0  0  0  0  0  6  8  0  0  0  0  0  0  20 
20 0  1  5  5  4  0  6  8  0  1  5  5  5  5  5  4  0  6  8  0  1  5  5  4  0  20 
20 0  2  7  7  3  0  2  3  0  2  7  7  7  7  7  3  0  2  3  0  2  7  7  3  0  20 
20 0  0  0  0  0  0  0  0  0  0  0  0  0  0  0  0  0  0  0  0  0  0  0  0  0  20 
20 0  1  5  5  4  0  10 24 24 24 24 13 0  10 24 24 24 24 13 0  1  5  5  4  0  20 
20 0  6  9  9  8  0  20 0  0  0  0  20 0  20 0  0  0  0  20 0  6  9  9  8  0  20 
20 0  2  7  7  3  0  20 0  0  0  0  20 0  20 0  0  0  0  20 0  2  7  7  3  0  20 
20 0  0  0  0  0  0  20 0  0  0  0  20 0  20 0  0  0  0  20 0  0  0  0  0  0  20 
11 24 24 24 24 24 24 16 24 24 24 24 16 24 16 24 24 24 24 16 24 24 24 24 24 24 12 