23 23 23 23 23 23 23 23 23 23 23 23 23 23 23 23 23 23 23 23 23 23 23 23 23 23 23 
23 0  0  0  0  0  0  23 0  0  0  0  23 0  23 0  0  0  0  23 0  0  0  0  0  0  23 
23 0  23 23 23 23 0  23 0  0  0  0  23 0  23 0  0  0  0  23 0  23 23 23 23 0  23 
23 0  23 23 23 23 0  23 0  0  0  0  23 0  23 0  0  0  0  23 0  23 23 23 23 0  23 
23 0  23 23 23 23 0  23 23 23 23 23 23 0  23 23 23 23 23 23 0  23 23 23 23 0  23 
23 0  0  0  0  0  0  0  0  0  0  0  0  0  0  0  0  0  0  0  0  0  0  0  0  0  23 
23 0  23 23 23 23 0  23 23 0  23 23 23 23 23 23 23 0  23 23 0  23 23 23 23 0  23 
23 0  23 23 23 23 0  23 23 0  23 23 23 23 23 23 23 0  23 23 0  23 23 23 23 0  23 
23 0  0  0  0  0  0  23 23 0  0  0  0  0  0  0  0  0  23 23 0  0  0  0  0  0  23 
23 23 23 23 23 23 0  23 23 0  23 23 23 0  23 23 23 0  23 23 0  23 23 23 23 23 23 
0  0  0  0  0  23 0  23 23 0  23 23 23 0  23 23 23 0  23 23 0  23 0  0  0  0  0  
0  0  0  0  0  23 0  23 23 0  0  0  0  0  0  0  0  0  23 23 0  23 0  0  0  0  0  
0  0  0  0  0  23 0  23 23 0  0  23 23 26 23 23 0  0  23 23 0  23 0  0  0  0  0  
23 23 23 23 23 23 0  23 23 0  0  23 0  0  0  23 0  0  23 23 0  23 23 23 23 23 23 
23 0  0  0  0  0  0  0  0  0  0  23 0  0  0  23 0  0  0  0  0  0  0  0  0  0  23 
23 23 23 23 23 23 0  23 23 0  0  23 0  0  0  23 0  0  23 23 0  23 23 23 23 23 23 
0  0  0  0  0  23 0  23 23 0  0  23 23 23 23 23 0  0  23 23 0  23 0  0  0  0  0  
0  0  0  0  0  23 0  23 23 0  0  0  0  0  0  0  0  0  23 23 0  23 0  0  0  0  0  
0  0  0  0  0  23 0  23 23 0  23 23 23 0  23 23 23 0  23 23 0  23 0  0  0  0  0  
23 23 23 23 23 23 0  23 23 0  23 23 23 0  23 23 23 0  23 23 0  23 23 23 23 23 23 
23 0  0  0  0  0  0  23 23 0  0  0  0  0  0  0  0  0  23 23 0  0  0  0  0  0  23 
23 0  23 23 23 23 0  23 23 0  23 23 23 23 23 23 23 0  23 23 0  23 23 23 23 0  23 
23 0  23 23 23 23 0  23 23 0  23 23 23 23 23 23 23 0  23 23 0  23 23 23 23 0  23 
23 0  0  0  0  0  0  0  0  0  0  0  0  0  0  0  0  0  0  0  0  0  0  0  0  0  23 
23 0  23 23 23 23 0  23 23 23 23 23 23 0  23 23 23 23 23 23 0  23 23 23 23 0  23 
23 0  23 23 23 23 0  23 0  0  0  0  23 0  23 0  0  0  0  23 0  23 23 23 23 0  23 
23 0  23 23 23 23 0  23 0  0  0  0  23 0  23 0  0  0  0  23 0  23 23 23 23 0  23 
23 0  0  0  0  0  0  23 0  0  0  0  23 0  23 0  0  0  0  23 0  0  0  0  0  0  23 
23 23 23 23 23 23 23 23 23 23 23 23 23 23 23 23 23 23 23 23 23 23 23 23 23 23 23  